R 1280 720
NO ./texture/h4.xpm
SO ./texture/h2.xpm
WE ./texture/h1.xpm
EA ./texture/h3.xpm
S ./texture/venom.xpm
F 7,7,7
C 2,0,24

111111111111111111111111111111111111
1000000000000000000000000000000001S1
100200002000000020000001111110000101
100000020000002000000000001110000101
100002000001111111110000000000020101
111110000000011111110000022000000101
    10000000000111110000000000002101
    11110000000000110000020000200101
       10000000200010000000002000101
       10000000000010000002000000101
       11100000200010000000000020101
         100000000010000002000000101
         100000000010000000000200101
         111000000000000010000000101
           1000000000000000000000101
           1111111110000000000000101
                   11000000000002101
                    1111000000000101
                       1110000000101
                         11100020101
                           100000001
                           111000001
                             1100001
                              110001
                               11001
                                1101
                                 111