R 9999999 899999
NO ./texture/3d1.xpm
SO ./texture/3d2.xpm
WE ./texture/3d3.xpm
EA ./texture/3d4.xpm
F 245,245,245
C        220,220,220

S ./texture/3ds.xpm
111111111111111111111111111111111111
100000000000000000000000000000000001
100200002000000020000001111110000001
100000020000002000000000001110000021
100002000001111111110000000000020001
111110000000011111110000022000000001
    10000000000111110000000000002001
    11110000000000110000020000200001
       10000000200010000000002000001
       10000000000010000002000000001
       111000002000100E0000000020001
         100000000010000002000000001
         100000000010000000000200001
         111000000000000010000000001
           1000000000000000000000001
           1111111110000000000000001
                   11000000000002001
                    1111000000000001
                       1110000000001
                         11100020001
                           100000001
                           111000001
                             1100001
                              110001
                               11001
                                1101
                                 111