R 1280 720
NO ./texture/i.xpm
SO ./texture/p.xpm
WE ./texture/o.xpm
EA ./texture/3d3.xpm
S ./texture/bill.xpm
F 101,67,33
C 172,253,255

11111111111111111111
1E000000000000000001
12002002002002002001
12002002002002002001
12002002002002002001
12002002002002002001
12222220000002222221
12222220001002222221
12222220000002222221
12222220000002222221
11111111111111111111