R 1280 720
NO ./texture/p.xpm
SO ./texture/o.xpm
WE ./texture/i.xpm
EA ./texture/3d1.xpm
S ./texture/bill.xpm
F 101,67,33
C 36,36,36

        1111111111111111111111111
        1000000000110000000000001
        1011000001110000000000001
        1001000000000022220000001
111111111011000001110000000000001
100000000011000001110111111111111
11110111111111011100000010001
11110111111111011101010010001
11000000110101011100022010001
10202020000000001100000010001
10000N00000000001101010010001
1100000111010101111101111000111
11110111 1110101 101111010001
11111111 1111111 111111111111